1 1 1 1 1 1 1 1 1 1 1 1 1 1 1 1 1 1 1 1 1 1 1 1 1 1 1 1 1 1 1 1 1 1 1 1 1 1 1 1 1 1 1 1 1 1 1 1 1 1 
1 1 1 1 1 1 1 1 1 1 1 4 1 1 1 1 1 1 1 1 1 1 1 1 1 1 4 1 4 1 1 1 1 1 1 1 1 1 1 1 1 1 1 1 1 1 1 1 1 1 
1 1 1 1 1 1 1 1 1 1 1 1 1 4 4 4 4 4 4 4 4 4 4 4 4 1 1 1 1 1 4 4 4 1 4 4 4 4 4 4 4 4 4 4 4 4 4 4 1 1 
1 1 1 1 1 1 1 1 1 1 1 1 4 4 4 4 4 4 4 4 4 4 4 4 4 4 4 4 4 4 4 4 4 4 4 4 4 4 4 4 4 4 4 4 4 4 4 4 1 1 
1 1 1 1 1 1 4 4 4 4 1 4 4 4 4 4 4 4 4 4 4 4 4 4 4 4 4 4 4 4 4 4 4 4 4 4 4 4 4 4 4 4 4 4 4 4 4 4 1 1 
1 1 1 1 1 4 4 4 4 4 4 4 4 4 4 4 4 4 4 4 4 4 4 4 4 4 4 4 4 4 4 4 4 4 4 4 4 4 4 4 4 4 4 4 4 4 4 1 1 1 
1 1 1 1 1 4 4 4 4 4 4 4 4 4 4 4 4 4 4 4 4 4 4 4 4 4 4 4 4 4 4 4 4 4 4 4 4 4 4 4 4 4 4 4 4 4 4 1 1 1 
1 1 1 1 1 4 4 4 4 4 4 4 4 4 4 4 4 4 4 4 4 4 4 4 4 4 4 4 4 4 4 4 4 4 4 4 4 4 4 4 4 4 4 4 4 4 4 1 1 1 
1 1 1 1 1 4 4 4 4 4 4 4 4 4 4 4 4 4 4 4 4 4 4 4 4 4 4 4 4 4 4 4 4 4 4 4 4 4 4 4 4 4 4 4 4 4 4 1 1 1 
1 1 1 1 1 4 4 4 4 4 4 4 4 4 4 4 4 4 4 4 4 4 4 4 4 4 4 4 4 4 4 4 4 4 4 4 4 4 4 4 4 4 4 4 4 4 4 1 1 1 
1 1 1 1 1 1 4 4 4 4 4 4 4 4 4 4 4 4 4 4 4 4 4 4 4 4 4 4 4 4 4 4 4 4 4 4 4 4 4 4 4 4 4 4 4 4 4 1 1 1 
1 1 1 1 1 1 4 4 4 4 4 4 4 4 4 4 4 4 4 4 4 4 4 4 4 4 4 4 4 4 4 4 4 4 4 4 4 4 4 4 4 4 4 4 4 4 4 4 1 1 
1 1 1 1 1 1 4 4 4 4 4 4 4 4 4 4 4 4 4 4 4 4 4 4 4 4 4 4 4 4 4 4 4 4 4 4 4 4 4 4 4 4 4 4 4 4 4 4 1 1 
1 1 1 1 1 1 4 4 4 4 4 4 4 4 4 4 4 4 4 4 4 4 4 4 4 4 4 4 4 4 4 4 4 4 4 4 4 4 4 4 4 4 4 4 4 4 4 4 1 1 
1 1 1 1 1 1 1 4 4 4 4 4 4 4 4 4 4 4 4 4 4 4 4 4 4 4 4 4 4 4 4 4 4 4 4 4 4 4 4 4 4 4 4 4 4 4 4 4 1 1 
1 1 1 1 1 1 1 1 1 1 1 4 4 4 4 4 4 4 4 4 4 4 5 4 4 4 4 4 4 4 4 4 4 4 4 4 4 4 4 4 4 4 4 4 4 4 4 4 1 1 
1 1 1 1 1 1 1 1 1 1 1 1 1 4 4 4 4 4 4 4 4 4 5 5 5 5 4 4 5 5 5 5 4 4 4 4 4 4 4 4 4 4 4 4 4 4 4 1 1 1 
1 1 1 1 1 1 1 1 1 1 1 1 1 1 1 4 4 4 4 4 4 4 0 0 0 0 9 9 0 0 0 0 8 4 4 4 4 4 4 4 4 4 4 4 4 1 1 1 1 1 
1 1 1 1 1 1 4 1 1 1 1 1 1 1 1 1 1 4 4 4 4 4 0 0 0 0 9 9 0 0 0 0 8 4 4 4 4 4 4 4 4 4 4 1 1 1 1 1 1 1 
1 1 1 1 1 1 4 4 4 1 1 1 1 1 1 1 1 1 1 4 4 4 0 0 0 0 9 9 0 0 0 0 8 4 4 1 1 1 1 1 1 1 1 1 1 1 1 1 1 1 
1 1 4 4 4 4 4 4 4 4 4 1 1 1 1 1 1 1 1 1 1 1 0 0 0 0 9 9 0 0 0 0 8 4 4 1 1 1 1 1 1 1 1 1 1 1 1 1 1 1 
1 1 4 4 4 4 4 4 4 4 4 4 4 1 1 1 1 1 1 1 1 1 6 6 6 0 9 9 0 1 1 1 1 1 1 1 1 1 1 1 1 1 1 1 1 1 1 1 1 1 
1 1 4 4 4 4 4 4 4 4 4 4 4 4 4 4 4 4 1 1 1 1 1 1 1 0 9 9 0 1 1 1 1 1 1 1 1 1 1 1 1 1 1 1 1 1 1 1 1 1 
1 1 4 4 4 4 4 4 4 4 4 4 4 4 4 4 4 4 4 4 4 7 0 0 0 0 9 9 0 0 0 0 8 1 1 1 1 1 1 1 1 1 1 1 1 1 1 1 1 1 
1 1 4 4 4 4 4 4 4 4 4 4 4 4 4 4 4 4 4 4 4 7 0 0 0 0 9 9 0 0 0 0 8 4 4 4 4 4 4 4 4 4 4 4 4 4 4 4 1 1 
1 1 4 4 4 4 4 4 4 4 4 4 4 4 4 4 4 4 4 4 4 7 0 0 0 0 9 9 0 0 0 0 8 4 4 4 4 4 4 4 4 4 4 4 4 4 4 4 1 1 
1 1 4 4 4 4 4 4 4 4 4 4 4 4 4 4 4 4 4 4 4 7 0 0 0 0 9 9 0 0 0 0 8 4 4 4 4 4 4 4 4 4 4 4 3 4 4 4 1 1 
1 1 4 4 4 4 4 4 4 4 4 4 4 4 4 4 4 4 4 4 3 7 0 0 0 0 9 9 0 0 0 0 8 4 4 4 4 4 4 4 4 4 3 3 3 4 4 4 1 1 
1 1 4 4 4 4 4 4 4 4 4 4 4 4 4 4 4 4 4 4 4 4 6 6 6 6 2 2 6 6 6 6 4 4 4 4 4 4 4 4 4 3 3 3 3 4 4 4 1 1 
1 1 4 4 4 4 4 4 4 4 4 4 4 4 4 4 4 4 4 4 4 4 4 4 4 4 2 2 4 4 4 4 4 4 4 4 4 4 4 3 3 3 4 3 4 4 4 4 1 1 
1 1 4 4 4 4 4 4 4 4 4 4 4 4 4 4 4 4 4 4 4 4 4 4 4 4 2 2 4 4 4 4 4 4 4 4 4 4 4 3 3 3 3 3 4 4 4 4 1 1 
1 1 4 4 4 4 4 4 4 4 3 4 4 4 4 4 4 4 4 4 4 4 4 4 4 4 4 4 4 4 4 4 4 4 4 3 3 3 3 3 3 3 3 4 4 4 4 4 1 1 
1 1 4 4 4 4 4 4 4 4 3 3 4 4 4 4 4 4 4 4 4 4 4 4 4 4 4 4 4 4 4 4 4 3 3 3 3 3 3 3 3 3 4 4 4 4 4 4 1 1 
1 1 4 4 4 4 4 4 4 4 4 3 4 4 4 4 4 4 4 4 4 4 4 4 4 4 4 4 4 4 4 4 4 3 4 4 3 3 3 3 3 3 3 4 4 4 4 4 1 1 
1 1 4 4 4 4 4 4 4 4 4 4 3 4 4 4 3 2 4 4 4 3 3 3 3 4 4 4 4 4 4 4 3 4 4 3 3 3 3 3 3 4 3 4 4 4 4 4 1 1 
1 1 4 4 4 4 4 4 4 4 4 4 4 3 3 4 4 4 3 3 3 3 4 4 3 3 3 2 2 2 4 3 3 3 3 4 4 3 3 3 3 4 3 4 4 4 4 1 1 1 
1 1 4 4 4 4 4 4 4 4 4 4 4 4 3 3 3 3 3 3 3 3 3 2 2 2 3 3 3 3 3 3 3 3 2 4 3 3 4 4 3 4 3 4 4 4 4 1 1 1 
1 1 4 4 4 4 4 4 4 4 4 4 3 4 4 3 3 3 4 3 3 3 2 3 3 2 2 2 3 3 3 2 2 3 3 3 3 4 4 4 3 3 3 4 4 4 4 1 1 1 
1 1 4 4 4 4 4 4 4 4 4 4 3 3 4 4 4 3 3 4 2 3 3 3 3 3 3 3 3 3 3 2 3 3 3 2 2 2 4 4 3 3 4 4 4 4 4 1 1 1 
1 1 4 4 4 4 4 4 4 4 4 4 4 3 4 4 4 4 3 4 4 2 2 3 3 3 2 2 2 3 3 3 3 2 2 2 4 4 4 4 3 4 4 4 4 4 4 4 1 1 
1 1 4 4 4 4 4 4 4 4 4 4 4 4 3 4 4 4 3 3 4 4 2 2 2 3 3 3 3 3 2 2 4 3 3 3 3 3 3 3 3 3 4 4 4 4 4 4 1 1 
1 1 4 4 4 4 4 4 4 4 4 4 4 4 4 3 4 4 3 3 3 3 3 3 2 3 3 2 3 3 3 3 4 4 4 3 3 4 3 3 4 3 4 3 4 4 4 4 1 1 
1 1 4 4 4 4 4 4 4 4 4 4 4 4 4 3 3 3 3 4 3 3 3 3 3 3 3 3 3 3 3 3 3 3 3 3 3 3 3 3 3 3 3 3 4 4 4 4 1 1 
1 1 4 4 4 4 4 4 4 4 4 4 4 4 4 4 4 4 4 4 4 4 4 4 4 4 4 3 3 4 4 4 4 4 4 4 4 4 4 4 4 3 3 4 4 4 4 4 1 1 
1 1 4 4 4 4 4 4 4 4 4 4 4 4 4 4 4 4 4 4 4 4 4 4 4 4 4 4 4 4 4 4 4 4 4 4 4 4 4 4 4 4 4 4 4 4 4 4 1 1 
1 1 4 4 4 4 4 4 4 4 4 4 4 4 4 4 4 4 4 4 4 4 4 4 4 4 4 4 1 1 1 1 4 4 4 4 4 4 4 4 4 4 4 4 4 4 4 4 1 1 
1 1 4 4 4 4 4 4 4 4 4 4 4 4 4 4 4 4 4 4 4 4 4 4 4 4 4 1 1 1 1 1 1 1 4 4 4 4 4 4 4 4 4 4 4 4 4 4 1 1 
1 1 4 4 4 4 4 4 4 4 4 4 4 4 4 4 4 4 4 4 4 4 4 4 1 4 1 1 1 1 1 1 1 1 1 1 1 1 1 4 1 4 4 4 4 1 4 1 1 1 
1 1 1 1 1 1 1 1 1 1 1 4 4 1 4 1 1 1 1 1 4 1 1 1 1 1 1 1 1 1 1 1 1 1 1 1 1 1 1 1 1 1 1 1 1 1 1 1 1 1 
1 1 1 1 1 1 1 1 1 1 1 1 1 1 1 1 1 1 1 1 1 1 1 1 1 1 1 1 1 1 1 1 1 1 1 1 1 1 1 1 1 1 1 1 1 1 1 1 1 1 
