11 11 11 11 11 11 11 11 11 11 11 11 11 11 11 11 11 11 11 11 11 11 30 30 30 30 30 30 30 11 11 11 11 11 11 11 11 11 11 11 11 11 11 11 11 11 11 11 11 11 
11 11 11 11 11 11 11 11 11 11 11 11 11 11 11 11 11 11 11 11 11 11 30 30 30 30 30 30 30 11 11 11 11 11 11 11 11 11 11 11 11 11 11 11 11 11 11 11 11 11 
11 11 11 11 11 11 11 11 11 11 11 11 11 11 11 11 11 11 11 11 11 11 30 30 30 30 30 30 30 11 11 11 11 11 11 11 11 11 11 11 11 11 11 11 11 11 11 11 11 11 
11 11 11 11 11 11 11 11 11 11 11 11 11 11 11 11 11 11 11 11 11 11 30 30 30 30 30 30 30 11 11 11 11 11 11 11 11 11 11 11 11 11 11 11 11 11 11 11 11 11 
11 11 11 11 11 11 11 11 11 11 11 11 11 11 11 11 11 11 11 11 11 11 30 30 30 30 30 30 30 11 11 11 11 11 11 11 11 11 11 11 11 11 11 11 11 11 11 11 11 11 
11 11 11 11 11 11 11 11 11 11 11 11 11 11 11 11 11 11 11 11 11 11 30 30 30 30 30 30 30 11 11 11 11 11 11 11 11 11 11 11 11 11 11 11 11 11 11 11 11 11 
11 11 11 11 11 11 11 11 11 11 11 11 11 11 11 11 11 11 11 11 11 11 11 1 4 30 4 7 11 11 11 11 11 11 11 11 11 11 11 11 11 11 11 11 11 11 11 11 11 11 
11 11 11 11 11 11 11 11 11 11 11 11 11 11 11 11 11 11 11 11 11 11 11 2 5 30 5 8 11 11 11 11 11 11 11 11 11 11 11 11 11 11 11 11 11 11 11 11 11 11 
11 11 11 11 11 11 11 11 11 11 11 11 11 11 11 11 11 11 11 11 11 11 11 2 5 30 5 8 11 11 11 11 11 11 11 11 11 11 11 11 11 11 11 11 11 11 11 11 11 11 
11 11 11 11 11 11 11 11 11 11 11 11 11 11 11 11 11 11 11 11 11 11 11 2 5 30 5 8 11 11 11 11 11 11 11 11 11 11 11 11 11 11 11 11 11 11 11 11 11 11 
11 11 11 11 11 11 11 11 11 11 11 11 11 11 11 11 11 11 11 11 11 11 11 2 5 30 5 8 11 11 11 11 11 11 11 11 11 11 11 11 11 11 11 11 11 11 11 11 11 11 
11 11 11 11 11 11 11 11 11 11 11 11 11 11 11 11 11 11 11 11 1 4 7 2 5 30 5 8 1 4 7 11 11 11 11 11 11 11 11 11 11 11 11 11 11 11 11 11 11 11 
11 11 11 11 11 11 11 9 9 9 9 9 9 9 9 11 11 11 11 11 2 5 8 3 6 30 6 0 2 5 8 11 11 11 11 11 11 11 11 11 11 11 11 11 11 11 11 11 11 11 
11 11 11 11 11 11 11 9 11 11 11 11 11 11 9 11 11 11 11 11 2 5 8 9 9 30 9 9 2 5 8 11 11 11 11 11 11 11 11 11 11 11 11 11 11 11 11 11 11 11 
11 11 11 11 11 11 11 9 11 9 9 9 9 11 9 11 11 11 11 11 2 5 8 9 10 10 10 9 2 5 8 11 11 11 11 11 11 11 11 11 11 11 11 11 11 11 11 11 11 11 
11 11 11 11 11 11 11 9 11 9 9 11 11 11 9 11 11 11 11 11 2 5 8 9 10 10 10 9 2 5 8 11 11 11 11 11 11 11 11 11 11 11 11 11 11 11 11 11 11 11 
11 11 11 11 11 11 11 9 11 9 11 11 9 11 9 11 11 11 11 11 2 5 8 9 10 10 11 9 2 5 8 11 11 11 11 11 11 11 11 11 11 11 11 11 11 11 11 11 11 11 
11 11 11 11 11 11 11 9 11 9 11 9 9 11 9 11 11 11 11 11 2 5 8 9 11 11 11 9 2 5 8 11 11 11 11 11 11 11 11 11 11 11 11 11 11 11 11 11 11 11 
11 11 11 11 11 11 11 9 11 9 11 11 9 11 9 11 11 11 11 11 2 5 8 9 11 11 11 9 2 5 8 11 11 11 11 11 11 11 11 11 11 11 11 11 11 11 11 11 11 11 
11 11 11 11 11 11 11 9 11 9 9 11 9 11 9 11 11 11 11 11 3 6 0 9 11 11 11 9 3 6 0 11 11 11 11 11 11 11 11 11 11 11 11 11 11 11 11 11 11 11 
11 11 11 11 11 11 11 9 11 9 11 11 9 11 9 11 11 11 11 11 11 11 11 9 11 11 11 9 11 11 11 11 11 11 11 11 11 11 11 11 11 11 11 11 11 11 11 11 11 11 
11 11 11 11 11 11 11 9 11 9 10 9 9 11 9 11 11 11 11 11 11 11 11 9 11 11 11 9 11 11 11 11 11 11 11 11 11 11 11 11 11 11 11 11 11 11 11 11 11 11 
11 11 11 11 11 11 11 9 11 9 10 11 9 11 9 11 11 11 11 11 11 11 11 9 11 11 11 9 11 11 11 11 11 11 11 9 11 11 11 11 11 11 11 11 11 11 11 11 11 11 
11 11 11 11 11 11 11 9 11 9 9 10 9 10 9 11 11 11 11 9 9 9 9 9 11 10 11 9 9 9 9 9 9 9 9 9 9 9 9 9 9 11 11 11 11 11 11 11 11 11 
11 11 11 11 11 11 11 9 11 9 10 11 9 11 9 11 11 11 11 9 11 11 11 11 11 10 11 11 11 11 11 10 10 11 11 11 11 11 11 11 9 11 11 11 11 11 11 11 11 11 
11 11 11 11 11 11 11 9 11 9 9 9 9 11 9 11 11 11 11 9 11 11 11 11 11 9 11 9 9 9 11 11 9 9 9 11 9 9 9 11 9 11 11 11 11 11 11 11 11 11 
11 11 11 11 11 11 11 9 11 9 11 11 11 11 9 11 11 11 11 9 11 9 11 9 11 9 11 9 11 9 11 11 9 11 9 11 9 11 9 11 9 11 11 11 11 11 11 11 11 11 
11 11 11 11 11 11 11 9 11 9 9 9 9 9 9 9 9 9 9 9 11 9 11 11 11 9 11 9 11 9 11 11 9 11 9 11 9 11 9 11 9 11 11 11 11 11 11 11 11 11 
11 11 11 11 11 11 11 9 11 11 11 11 11 11 11 11 11 11 11 9 11 9 9 9 11 9 11 9 11 9 11 11 9 11 9 11 9 11 9 11 9 11 11 11 11 11 11 11 11 11 
11 11 11 11 11 11 11 9 9 9 9 9 9 9 9 9 9 9 11 9 11 11 11 9 11 9 11 9 11 9 11 11 9 9 9 11 9 11 9 11 9 11 11 11 11 11 11 11 11 11 
11 11 11 11 11 11 11 11 11 11 11 11 11 11 11 11 9 9 11 9 9 11 9 9 11 9 11 9 11 9 11 11 9 9 9 11 9 9 9 10 9 11 11 11 11 11 11 11 11 11 
11 11 11 11 11 11 11 11 11 11 11 11 11 11 11 11 11 9 11 9 9 11 9 9 11 9 11 9 11 9 11 11 9 9 9 9 9 11 9 9 9 11 11 11 11 11 11 11 11 11 
11 11 11 11 11 11 11 11 11 11 11 11 11 11 11 11 11 9 11 11 11 12 11 9 11 9 11 9 11 9 11 9 10 11 9 11 11 11 11 11 11 11 11 11 11 11 11 11 11 11 
11 11 11 11 11 11 11 11 11 11 11 11 11 11 11 11 11 9 9 22 26 15 19 11 11 9 11 9 11 9 11 9 9 11 9 11 11 11 11 11 11 11 11 11 11 11 11 11 11 11 
11 11 11 11 11 11 11 11 11 11 11 11 11 11 11 11 11 11 9 23 27 16 20 11 11 9 11 9 11 9 11 9 9 11 9 11 11 11 11 11 11 11 11 11 11 11 11 11 11 11 
11 11 11 11 11 11 11 11 11 11 11 11 11 11 11 11 11 11 9 24 28 17 13 11 11 9 11 9 11 9 11 9 9 11 9 11 11 11 11 11 11 11 11 11 11 11 11 11 11 11 
11 11 11 11 11 11 11 11 11 11 11 11 11 11 11 11 11 11 9 25 14 18 21 11 11 9 11 9 11 9 11 9 9 11 9 11 11 11 11 11 11 11 11 11 11 11 11 11 11 11 
11 11 11 11 11 11 11 11 11 11 11 11 11 11 11 11 11 11 9 11 11 11 11 11 11 9 11 9 11 9 11 9 9 11 9 11 11 11 11 11 11 11 11 11 11 11 11 11 11 11 
11 11 11 11 11 11 11 11 11 11 11 11 11 11 11 11 11 11 9 11 11 11 11 11 11 9 11 9 11 9 11 9 9 11 9 11 11 11 11 11 11 11 11 11 11 11 11 11 11 11 
11 11 11 11 11 11 11 11 11 11 11 11 11 11 11 11 11 11 9 9 9 9 9 9 9 9 11 9 11 9 11 9 9 11 9 11 11 11 11 11 11 11 11 11 11 11 11 11 11 11 
11 11 11 11 11 11 11 11 11 11 11 11 11 11 11 11 11 11 11 11 11 11 11 11 11 9 11 11 11 9 11 11 11 11 9 11 11 11 11 11 11 11 11 11 11 11 11 11 11 11 
11 11 11 11 11 11 11 11 11 11 11 11 11 11 11 11 11 11 11 11 11 11 11 11 11 11 9 9 9 9 9 9 9 9 9 11 11 11 11 11 11 11 11 11 11 11 11 11 11 11 
11 11 11 11 11 11 11 11 11 11 11 11 11 11 11 11 11 11 11 11 11 11 11 11 11 11 11 11 11 11 11 11 11 11 11 11 11 11 11 11 11 11 11 11 11 11 11 11 11 11 
11 11 11 11 11 11 11 11 11 11 11 11 11 11 11 11 11 11 11 11 11 11 11 11 11 11 11 11 11 11 11 11 11 11 11 11 11 11 11 11 11 11 11 11 11 11 11 11 11 11 
11 11 11 11 11 11 11 11 11 11 11 11 11 11 11 11 11 11 11 11 11 11 11 11 11 11 11 11 11 11 11 11 11 11 11 11 11 11 11 11 11 11 11 11 11 11 11 11 11 11 
11 11 11 11 11 11 11 11 11 11 11 11 11 11 11 11 11 11 11 11 11 11 11 11 11 11 11 11 11 11 11 11 11 11 11 11 11 11 11 11 11 11 11 11 11 11 11 11 11 11 
11 11 11 11 11 11 11 11 11 11 11 11 11 11 11 11 11 11 11 11 11 11 11 11 11 11 11 11 11 11 11 11 11 11 11 11 11 11 11 11 11 11 11 11 11 11 11 11 11 11 
11 11 11 11 11 11 11 11 11 11 11 11 11 11 11 11 11 11 11 11 11 11 11 11 11 11 11 11 11 11 11 11 11 11 11 11 11 11 11 11 11 11 11 11 11 11 11 11 11 11 
11 11 11 11 11 11 11 11 11 11 11 11 11 11 11 11 11 11 11 11 11 11 11 11 11 11 11 11 11 11 11 11 11 11 11 11 11 11 11 11 11 11 11 11 11 11 11 11 11 11 
11 11 11 11 11 11 11 11 11 11 11 11 11 11 11 11 11 11 11 11 11 11 11 11 11 11 11 11 11 11 11 11 11 11 11 11 11 11 11 11 11 11 11 11 11 11 11 11 11 11 
